"filename", "language", "TypeScript JSX", "JavaScript JSX", "comment", "blank", "total"
"f:\学习\大三下\项目实训\sapphire-client\src\api\getHeat.jsx", "JavaScript JSX", 0, 2, 0, 0, 2
"f:\学习\大三下\项目实训\sapphire-client\src\components\CommentArea.jsx", "JavaScript JSX", 0, 140, 24, 3, 167
"f:\学习\大三下\项目实训\sapphire-client\src\components\MyDataSet.tsx", "TypeScript JSX", 34, 0, 0, 0, 34
"f:\学习\大三下\项目实训\sapphire-client\src\components\helpers\Interface.tsx", "TypeScript JSX", 2, 0, 0, 0, 2
"f:\学习\大三下\项目实训\sapphire-client\src\constants\url.jsx", "JavaScript JSX", 0, 7, 1, 0, 8
"f:\学习\大三下\项目实训\sapphire-client\src\pages\about\About.tsx", "TypeScript JSX", 129, 0, 0, 3, 132
"f:\学习\大三下\项目实训\sapphire-client\src\pages\consoleboard\ConsoleBoard.tsx", "TypeScript JSX", -5, 0, 5, 0, 0
"f:\学习\大三下\项目实训\sapphire-client\src\pages\consoleboard\NewsPanel.tsx", "TypeScript JSX", 13, 0, -11, 0, 2
"f:\学习\大三下\项目实训\sapphire-client\src\pages\dataset\DatasetComments.tsx", "TypeScript JSX", 87, 0, 0, 2, 89
"f:\学习\大三下\项目实训\sapphire-client\src\pages\dataset\DatasetDetail.tsx", "TypeScript JSX", 48, 0, 0, 0, 48
"f:\学习\大三下\项目实训\sapphire-client\src\pages\dataset\ProgressTab.tsx", "TypeScript JSX", 26, 0, 19, 1, 46
"f:\学习\大三下\项目实训\sapphire-client\src\pages\dataset\UpdDataset.tsx", "TypeScript JSX", 1, 0, 2, 0, 3
"f:\学习\大三下\项目实训\sapphire-client\src\pages\login\index.jsx", "JavaScript JSX", 0, 26, 1, 2, 29
"f:\学习\大三下\项目实训\sapphire-client\src\pages\profile\HistoryInfoPanel.tsx", "TypeScript JSX", 2, 0, 3, 1, 6
"f:\学习\大三下\项目实训\sapphire-client\src\pages\workdesk\WorkDesk.tsx", "TypeScript JSX", 27, 0, 8, 2, 37
"f:\学习\大三下\项目实训\sapphire-client\src\pages\workshop\DetailList.tsx", "TypeScript JSX", 0, 0, 5, 0, 5
"f:\学习\大三下\项目实训\sapphire-client\src\pages\workshop\LeaderBoard.tsx", "TypeScript JSX", 17, 0, 0, 0, 17
"f:\学习\大三下\项目实训\sapphire-client\src\pages\workshop\Workshop.tsx", "TypeScript JSX", 6, 0, 0, -1, 5
"f:\学习\大三下\项目实训\sapphire-client\src\router\index.tsx", "TypeScript JSX", 9, 0, 0, 0, 9
"Total", "-", 396, 175, 57, 13, 641